19 19 10
...................
.#################.
.#...............#.
.#.#############.#.
.#.............#...
.#..#........#.#.#.
.#..#.######.#.#.#.
.#..#........#...#.
....#.#.#....#.#.#.
.#..#.#......#.#.#.
.#..#.######.#.#.#.
.#..#........#.#.#.
.#..##########.#.#.
.#.............#.#.
.#.#############.#.
.#...............#.
...................
.########.########.
...................
