17 17 8
.................
...#.........#...
...#.........#...
.###.#.....#.###.
.....#.....#.....
...###.#.#.###...
.......#.#.......
.....###.###.....
.................
.....###.###.....
.......#.#.......
...###.#.#.###...
.....#.....#.....
.###.#.....#.###.
...#.........#...
...#.........#...
.................
