21 21 12
.....................
.#.................#.
..#.....#...#.....#..
...#...#.....#...#...
....#.#..###..#.#....
.....#.........#.....
....#.#...#...#.#....
...#...#..#..#...#...
..#.....#...#.....#..
....#....#.#....#....
....#.##.....##.#....
....#....#.#....#....
..#.....#...#.....#..
...#...#..#..#...#...
....#.#...#...#.#....
.....#.........#.....
....#.#..###..#.#....
...#...#.....#...#...
..#.....#...#.....#..
.#.................#.
.....................
